########################################################
#......................................................#
#.#@..#####.#####.#####...#.#####...#####.#@..@#.#@..#.#
#J#@...@#@..#@@@#....@#...@.#@......#@....#@..@#.##@.#.#
#P#@...@#@..#@###.#####...#.#####...####..#@..@#.#@#@#.#
#.#@@@@@#@..#.....#@......#....@#...#@....#@@@@#.#.@##.#
#.#####@#@..#.....#####...#.#####...#@....######.#..@#.#
#......................................................#
########################################################